CarDemo=Демонстрація автомобілів
PreferencesTitle=Параметри
TypeLabel=Тип:
RoadLabel=Дорога:
DriveLabel=Привід:
MainMarkLabel=Марка:
TuningLabel=Тюнінг:
FuelLabel=Паливо:
CarTitle=Назва машини
RecommendationTitle=Рекомендовано
Don'tCare=Не важливо
Hatcback=Хетчбек
USF=Позашляховик
Don'tKnow=Не знаю
AMG=AMG
BRABUS=BRABUS
TRACK=Трек
OFFROAD=Бездоріжжя
HIGHWAY=ТРАСА
FUEL=ПАЛИВО
GAS=ГАЗ
BENZINE=БЕНЗИН
DIZEL=ДИЗЕЛЬ
Other=Інше
None=Нічого
MERSEDES=MERSEDES
BMW=BMW
WALKSWAGEN=WALKSWAGEN
GARAGE=ГАРАЖ
4wd=Повний
rwd=Задній
fwd=Передній
MANSORY=MANSORY
POSEIDON=POSEIDON
AUDI=AUDI
BUGATTI=BUGATTI
